111111111111111111111
111111111P11111111111
111100000000000001111
111111111111111111111
111111111111E11111111
111111111111111111111